"country","region","region_code","start_date","end_date","days","year","week","population","total_deaths","covid_deaths","expected_deaths","excess_deaths","non_covid_deaths","covid_deaths_per_100k","excess_deaths_per_100k","excess_deaths_pct_change"
"South Africa","South Africa","0",2019-12-29,2020-01-04,7,2020,"1",58775022,9931,0,9002,929,9931,0,1.58060340666482,0.103199289046878
"South Africa","South Africa","0",2020-01-05,2020-01-11,7,2020,"2",58775022,8726,0,8740,-14,8726,0,-0.0238196422963483,-0.00160183066361552
"South Africa","South Africa","0",2020-01-12,2020-01-18,7,2020,"3",58775022,8300,0,8598,-298,8300,0,-0.507018100307985,-0.0346592230751338
"South Africa","South Africa","0",2020-01-19,2020-01-25,7,2020,"4",58775022,8328,0,8370,-42,8328,0,-0.0714589268890448,-0.00501792114695343
"South Africa","South Africa","0",2020-01-26,2020-02-01,7,2020,"5",58775022,9193,0,8575,618,9193,0,1.05146706708166,0.0720699708454811
"South Africa","South Africa","0",2020-02-02,2020-02-08,7,2020,"6",58775022,8739,0,8758,-19,8739,0,-0.0323266574021869,-0.00216944507878514
"South Africa","South Africa","0",2020-02-09,2020-02-15,7,2020,"7",58775022,8600,0,8515,85,8600,0,0.144619256799257,0.00998238402818563
"South Africa","South Africa","0",2020-02-16,2020-02-22,7,2020,"8",58775022,8325,0,8345,-20,8325,0,-0.0340280604233547,-0.00239664469742362
"South Africa","South Africa","0",2020-02-23,2020-02-29,7,2020,"9",58775022,8735,0,8718,17,8735,0,0.0289238513598515,0.00194998852947914
"South Africa","South Africa","0",2020-03-01,2020-03-07,7,2020,"10",58775022,9082,0,8740,342,9082,0,0.581879833239365,0.0391304347826087
"South Africa","South Africa","0",2020-03-08,2020-03-14,7,2020,"11",58775022,8795,0,8512,283,8795,0,0.481497054990469,0.0332471804511278
"South Africa","South Africa","0",2020-03-15,2020-03-21,7,2020,"12",58775022,8591,0,8413,178,8591,0,0.302849737767857,0.0211577320813028
"South Africa","South Africa","0",2020-03-22,2020-03-28,7,2020,"13",58775022,8447,1,8717,-270,8446,0.00170140302116773,-0.459378815715288,-0.0309739589308248
"South Africa","South Africa","0",2020-03-29,2020-04-04,7,2020,"14",58775022,8236,8,8957,-721,8228,0.0136112241693419,-1.22671157826194,-0.0804957016858323
"South Africa","South Africa","0",2020-04-05,2020-04-11,7,2020,"15",58775022,8254,16,8753,-499,8238,0.0272224483386837,-0.849000107562699,-0.0570090254769793
"South Africa","South Africa","0",2020-04-12,2020-04-18,7,2020,"16",58775022,8120,27,8782,-662,8093,0.0459378815715288,-1.12632880001304,-0.0753814620815304
"South Africa","South Africa","0",2020-04-19,2020-04-25,7,2020,"17",58775022,7956,34,8965,-1009,7922,0.0578477027197029,-1.71671564835824,-0.112548800892359
"South Africa","South Africa","0",2020-04-26,2020-05-02,7,2020,"18",58775022,8030,37,9444,-1414,7993,0.0629519117832061,-2.40578387193118,-0.149724692926726
"South Africa","South Africa","0",2020-05-03,2020-05-09,7,2020,"19",58775022,8503,63,9380,-877,8440,0.107188390333567,-1.4921304495641,-0.0934968017057569
"South Africa","South Africa","0",2020-05-10,2020-05-16,7,2020,"20",58775022,8648,75,9440,-792,8573,0.12760522658758,-1.34751119276484,-0.0838983050847457
"South Africa","South Africa","0",2020-05-17,2020-05-23,7,2020,"21",58775022,8879,146,9250,-371,8733,0.248404841090489,-0.631220520853229,-0.0401081081081081
"South Africa","South Africa","0",2020-05-24,2020-05-30,7,2020,"22",58775022,9444,236,9909,-465,9208,0.401531112995585,-0.791152404842996,-0.0469270360278534
"South Africa","South Africa","0",2020-05-31,2020-06-06,7,2020,"23",58775022,10152,309,10493,-341,9843,0.52573353354083,-0.580178430218197,-0.0324978557133327
"South Africa","South Africa","0",2020-06-07,2020-06-13,7,2020,"24",58775022,10630,471,10629,1,10159,0.801360822970003,0.00170140302116773,0.0000940822278672204
"South Africa","South Africa","0",2020-06-14,2020-06-20,7,2020,"25",58775022,11976,454,10529,1447,11522,0.772436971610151,2.46193017162971,0.137429955361383
"South Africa","South Africa","0",2020-06-21,2020-06-27,7,2020,"26",58775022,12530,536,10595,1935,11994,0.911952019345905,3.29221484595956,0.182633317602643
"South Africa","South Africa","0",2020-06-28,2020-07-04,7,2020,"27",58775022,13511,613,10806,2705,12898,1.04296005197582,4.60229517225872,0.250323894132889
"South Africa","South Africa","0",2020-07-05,2020-07-11,7,2020,"28",58775022,14761,945,10507,4254,13816,1.60782585500351,7.23776845204754,0.404872941848292
"South Africa","South Africa","0",2020-07-12,2020-07-18,7,2020,"29",58775022,16243,977,10239,6004,15266,1.66227075168088,10.2152237390911,0.586385389198164
"South Africa","South Africa","0",2020-07-19,2020-07-25,7,2020,"30",58775022,16192,1707,9888,6304,14485,2.90429495713332,10.7256446454414,0.637540453074434
"South Africa","South Africa","0",2020-07-26,2020-08-01,7,2020,"31",58775022,15250,1498,10251,4999,13752,2.54870172570927,8.5053137028175,0.487659740513121
"South Africa","South Africa","0",2020-08-02,2020-08-08,7,2020,"32",58775022,13704,2057,10121,3583,11647,3.49978601454203,6.09612702484399,0.35401640154135
"South Africa","South Africa","0",2020-08-09,2020-08-15,7,2020,"33",58775022,12380,1467,9851,2529,10913,2.49595823205306,4.3028482405332,0.256725205562887
"South Africa","South Africa","0",2020-08-16,2020-08-22,7,2020,"34",58775022,11951,1310,9722,2229,10641,2.22883795772973,3.79242733418288,0.229273811972845
"South Africa","South Africa","0",2020-08-23,2020-08-29,7,2020,"35",58775022,11134,994,9700,1434,10140,1.69119460304073,2.43981193235453,0.147835051546392
"South Africa","South Africa","0",2020-08-30,2020-09-05,7,2020,"36",58775022,10917,798,10011,906,10119,1.35771961089185,1.54147113717797,0.0905004495055439
"South Africa","South Africa","0",2020-09-06,2020-09-12,7,2020,"37",58775022,10053,648,9521,532,9405,1.10250915771669,0.905146407261234,0.0558764835626511
"South Africa","South Africa","0",2020-09-13,2020-09-19,7,2020,"38",58775022,9561,513,9394,167,9048,0.872819749859047,0.284134304535011,0.0177773046625507
"South Africa","South Africa","0",2020-09-20,2020-09-26,7,2020,"39",58775022,9857,436,9267,590,9421,0.741811717229132,1.00382778248896,0.0636667745764541
"South Africa","South Africa","0",2020-09-27,2020-10-03,7,2020,"40",58775022,9491,562,9672,-181,8929,0.956188497896266,-0.30795394683136,-0.0187138130686518
"South Africa","South Africa","0",2020-10-04,2020-10-10,7,2020,"41",58775022,10052,735,9266,786,9317,1.25053122055828,1.33730277463784,0.0848262464925533
"South Africa","South Africa","0",2020-10-11,2020-10-17,7,2020,"42",58775022,10107,735,8962,1145,9372,1.25053122055828,1.94810645923705,0.127761660343673
"South Africa","South Africa","0",2020-10-18,2020-10-24,7,2020,"43",58775022,9922,536,8961,961,9386,0.911952019345905,1.63504830334219,0.107242495257226
"South Africa","South Africa","0",2020-10-25,2020-10-31,7,2020,"44",58775022,9799,332,9191,608,9467,0.564865803027688,1.03445303686998,0.0661516701120661
"South Africa","South Africa","0",2020-11-01,2020-11-07,7,2020,"45",58775022,9943,513,9063,880,9430,0.872819749859047,1.49723465862761,0.0970980911397992
"South Africa","South Africa","0",2020-11-08,2020-11-14,7,2020,"46",58775022,10273,417,8825,1448,9856,0.709485059826945,2.46363157465088,0.164079320113314
"South Africa","South Africa","0",2020-11-15,2020-11-21,7,2020,"47",58775022,10247,639,8715,1532,9608,1.08719653052618,2.60654942842897,0.175788869764773
"South Africa","South Africa","0",2020-11-22,2020-11-28,7,2020,"48",58775022,10058,594,9239,819,9464,1.01063339457363,1.39344907433637,0.0886459573546921
"South Africa","South Africa","0",2020-11-29,2020-12-05,7,2020,"49",58775022,11310,628,9379,1931,10682,1.06848109729334,3.28540923387489,0.205885488858087
"South Africa","South Africa","0",2020-12-06,2020-12-12,7,2020,"50",58775022,12244,1039,9015,3229,11205,1.76775773899328,5.49383035535061,0.358180809761509
"South Africa","South Africa","0",2020-12-13,2020-12-19,7,2020,"51",58775022,13575,1433,9528,4047,12142,2.43811052933336,6.88557802666582,0.424748110831234
"South Africa","South Africa","0",2020-12-20,2020-12-26,7,2020,"52",58775022,16870,1982,9632,7238,14888,3.37218078795445,12.3147550672121,0.751453488372093
"South Africa","South Africa","0",2020-12-27,2021-01-02,7,2020,"53",58775022,19922,2654,9416,10506,17268,4.51552361817916,17.8749401403882,1.11576040781648
"South Africa","South Africa","0",2021-01-03,2021-01-09,7,2021,"1",58775022,22599,3649,8912,13687,18950,6.20841962424106,23.2871031507228,1.53579443447038
"South Africa","South Africa","0",2021-01-10,2021-01-16,7,2021,"2",58775022,23879,4027,8645,15234,19852,6.85154996624246,25.9191736244693,1.76217466743783
"South Africa","South Africa","0",2021-01-17,2021-01-23,7,2021,"3",58775022,21787,3723,8504,13283,18064,6.33432344780747,22.599736330171,1.56197083725306
